v2.0 raw
2 2 2 2 2 2 2 2
6 0 2 2 2 2 6 0
2 2 0 2 2 2 0 2
2 2 0 2 1 1 1 1
3 7 0 2 0 2 0 3
0 0 2 6 1 7 1 3
7 0 0 4 0 3 3 3
4 2 2 2 2 2 2 2
4 4 2 2 2 4 0 0
4 1 3 4 1 4 2 2
2 4 3 3 3 3 3 3
4 3 3 3 3 3 3 3
3 4 0 0 2 4 0 2
2 4 8
